                         #
          #             ###
         ###      #    #####
        #####    ###  #######
       #######  ##############
      #########################
     ###########################
    ############################
   ##############################
    ##############################
     ##############################
      ##############################
       ##############################
       #############################
      #############################
     ################# ###########
      ###########################
       #########################
        #######################
       #######################
      #########################
     ###########################
    #############################
   ###############################
  #################################
 ###################################
###################################
 ################### # ###########
  #################     #########
   ###############       #######
    #############         #####
     ###########           ###
      #########             #
       #######
        #####
         ###
          #